T010000000000000011110001110110000000
T110000000000010010101001110110000000
T210000000000010010100001110110000000
T310000000000010010100101110110000000
T410000000000000011110001110110000000
T510000000000010010101001110110000000
T610000000000010010100001110110000000
T710000000000010010100101110110000000
T810000000000010010101001110110000000
T910000000000000011110001110110000000
T1010100000000000010100001110110000000
T1110100000000000010100001100110000000
T1210100110000000010100001110110000000
T1310100110000000010100001100110000000
T1410101000000000010100001110110000000
T1510101000000000010100001100110000000
T1610110000000000010100001110110000000
T1710110000000000010100001100110000000
T1810111000000000010100001110110000000
T1910000000000000010100001110110001000
T2010100000000000010100000010110010100
T2110000000010100010100001110110000000
T2210100000000000010100000010110010100
T2310100000000000010100001100110000000
T2410100000000000010100000010110011010
T2510000000010100010100001110110000000
T2610100000000000010100000010110011010
T2710100000000000010100001100110000000
T2810100000000000010100000010110010000
T2910100000000000010100000010110010100
T3010100000000000010100000010110011000
T3110100000000000010100000010110011010
T3210100000000000010100000110110000000
T3310100000000000010100001010110000000
T3410000000000000010100101110101100000
T3510000000000011010100001110110000000
T3611000001000000010100001110110000000
T3711000000000000010100001110110000000
T3810000000000000010100101110101000000
T3910000000011000010100001110110000000
T4010000000010000010100001110110000000
T4110000000000000010100101110100100000
T4210000000000000010100001110110000000
T4310000000000000010100001110110000000
T4410000000000000010100101110100000000
T4510000000000000010100001110110000000
T4610000000000000010100001110110000000
T4710000000000000010100001110110000000
T4810000000000000010100001110110000000
T4910000000000000010100001110110000000
T5010000000000000010100001110110000000
T5110000000000000011110001110110000000
T5210100110000000010100001101110000000
T5310100000000000010100010010110000000
T5410000000000000010100001110110001000
